111111111111111111111111111111111111111
11000100000000000000000000000000000C011
100001100000011111110111111111111111011
100N010000011111111C0011110001111111101
1000000011111110C00001010C0011111111011
1000011111111C0N0000000000N01111111C011
1001111111C0000000000000011111111000011
10111111C000000000000001111111000000011
101111CCCCCCC0CCCCCC01111111000000N0011
101111111111111111110111111100000111011
101111111111111111110111111111011111011
101111111111111111110111111111111111011
1C10000000000111111100000000000N0000011
110000P00000011111110110000C00000000011
110000E00000000000000111111111111100011
1C0000000000011111110000000C01000000C11
111111111111111111111111111111111111111