11111111111111111111111111111111111111111111111111111111111111111111
1P000000000000000000000000000000C110000000000000000000000000000000C1
11111111111111111111111111C111110110000000000000000000000000000000C1
100000000000000000000000011000010110000000000000000000000000000000C1
100000000000000000000000000000010110000000000000000000000000000000C1
100000000000000000000000000000010110000000000000000000000000000000C1
10000000000000000000000000000001011000000000000000000000000000000101
10000000000000000000000000000001011000000000000000000000000000000101
10000000000000000000000000000001011000000000000000000000000000000101
10000000000000000000000000000001011000000000000000000000000000000101
10000000000000000000000000000001000000000000000000000000000000000101
10000000000000000000000000000001010000000000000000000000000000000101
10000000000000000000000000000001010000000000000000N00000000000000101
10000000000000000000000000000001010000000000000000000000000000000101
10000000000000000000000000000001010000000000000000000000000000000101
10000000000000000000000000000001010000000000000000000000000000000101
11000000000000000000000000000001010000000000000000000000000000000101
1C111111111111111111111111111111010000000000000000000000000000000101
1E000000000000000000000000000000C10000000000000000000000000000000101
11111111111111111111111111111111111111111111111111111111111111111111
11111111111111111111111111111111111111111111111111111111111111111111
11111111111111111111111111111111111111111111111111111111111111111111
11111111111111111111111111111111111111111111111111111111111111111111
11111111111111111111111111111111111111111111111111111111111111111111
11111111111111111111111111111111111111111111111111111111111111111111
11111111111111111111111111111111111111111111111111111111111111111111
11111111111111111111111111111111111111111111111111111111111111111111
11111111111111111111111111111111111111111111111111111111111111111111
11111111111111111111111111111111111111111111111111111111111111111111
11111111111111111111111111111111111111111111111111111111111111111111
11111111111111111111111111111111111111111111111111111111111111111111
11111111111111111111111111111111111111111111111111111111111111111111
11111111111111111111111111111111111111111111111111111111111111111111
11111111111111111111111111111111111111111111111111111111111111111111
11111111111111111111111111111111111111111111111111111111111111111111
11111111111111111111111111111111111111111111111111111111111111111111
11111111111111111111111111111111111111111111111111111111111111111111
11111111111111111111111111111111111111111111111111111111111111111111
11111111111111111111111111111111111111111111111111111111111111111111