111111111111111
1CCCPCCCCCC00C1
1CCCCCCCCCC11C1
1CCCC1CCCCC11C1
1CCCCCCCCCCC101
1CCCCCCCCCC1CE1
111111111111111