1111111111111
10001PC100101
11111011000C1
1CN0000CEC001
1111111111111