111111111111111
1CCCPCCCCCCCCC1
1CCCCCCCCCC11C1
1CCCCCCCCCC11C1
1CCCCCCCCCCC1C1
1CCCCCCCCCC1CE1
111111111111111