1111111111111
1P0010C100101
11111011001C1
1C00000CEC001
1111111111111