111111111111111111111
1E00C0000000000C00111
101001010010000010111
101001001010101000111
1P0000000C00C00000111
111111111111111111111